F 119,2,114
C 250,128,114
SO textures/red.xpm
NO textures/eagle.xpm
WE textures/purplestone.xpm
EA textures/greystone.xpm

111111111111111111111
100000000000000000001
11111110000N000000001
      100000000100001
      100000000100001
      111111111111111
